one_v_one_gtw_venice = {
	126 2954 142 4698 163 164 3003 2348 4700 320 321
}
one_v_one_ww_africa = {
	2455 341 4566 2473 2454 2453 353 2452 354 2451 355 356 357 2326 2325 358 362 363 4317 2316 4316 361 2318 359 2317 4318 2320 2315 365 364
}
one_v_one_ww_egypt = {
	2326 2325 358 362 363 4317 2316 4316 361 2318 359 2317 4318 2320 2315 365 364
}
one_v_one_ww_libya = {
	2452 354 2451 355 356 357
}
one_v_one_ww_tunis = {
	2455 341 4566 2473 2454 2453 353
}
one_v_one_syw_india_fr = {
	2084 549 2080 2048 4448 4446 4447 4451 553 4441 2049 552 2043 4450
}
one_v_one_syw_india_gb = {
	2038 560 2096 4470 4471 561 2081 4476 4477 2039 4475 564 4478 4479
}
one_v_one_syw_phili_sp = {
	657 2698 658 656 2697 2699 4349 4350 2700 655 4356
}
one_v_one_syw_phili_po = {
	654 4351 4352 4353 2701 2702 4355 652 653 4354 651 
}
one_v_one_syw_portugal = {
	231 232 228 1851 4556 227 229 230 4150 4787
}